org.axiondb.TransactionManager	interface	5
org.axiondb.ComparisonOperator	classe	5
org.axiondb.FromNode	classe	15
org.axiondb.RowDecorator	classe	7
org.axiondb.AxionCommand	interface	7
org.axiondb.IndexLoader	interface	2
org.axiondb.RowComparator	classe	2
org.axiondb.TableFactory	interface	1
org.axiondb.Transactable	interface	3
org.axiondb.ConstraintViolationException	classe	1
org.axiondb.Sequence	classe	5
org.axiondb.tools.BatchSqlCommandRunner	classe	6
org.axiondb.tools.Defrag	classe	3
org.axiondb.tools.Console	classe	11
org.axiondb.Index	interface	8
org.axiondb.types.ShortType	classe	9
org.axiondb.types.ByteType	classe	9
org.axiondb.types.ByteArrayBlob	classe	12
org.axiondb.types.BlobSource	classe	6
org.axiondb.types.UnsignedShortType	classe	14
org.axiondb.types.LobLocatorFactory	interface	3
org.axiondb.types.FileLobLocatorFactory	classe	4
org.axiondb.types.FileLobLocator	classe	7
org.axiondb.types.LOBType	classe	21
org.axiondb.types.UnsignedByteType	classe	14
org.axiondb.types.StringType	classe	15
org.axiondb.types.FileLobSource	classe	5
org.axiondb.types.LobSource	interface	4
org.axiondb.types.FileOffsetLobLocator	classe	4
org.axiondb.types.LobLocator	interface	1
org.axiondb.types.BaseNumberDataType	classe	5
org.axiondb.types.ObjectType	classe	10
org.axiondb.types.TimestampType	classe	13
org.axiondb.types.FloatType	classe	10
org.axiondb.types.CompressedLOBType	classe	4
org.axiondb.types.IntegerType	classe	9
org.axiondb.types.FileOffsetLobSource	classe	4
org.axiondb.types.BooleanType	classe	11
org.axiondb.types.BooleanType$BooleanComparator	classe	2
org.axiondb.types.FileOffsetLobLocatorFactory	classe	3
org.axiondb.types.CompressedLobSource	classe	4
org.axiondb.types.CharacterType	classe	12
org.axiondb.types.ClobSource	classe	10
org.axiondb.types.BigDecimalType	classe	11
org.axiondb.types.LongType	classe	9
org.axiondb.types.BaseDataType	classe	36
org.axiondb.types.StringClob	classe	14
org.axiondb.types.AnyType	classe	23
org.axiondb.types.UnsignedIntegerType	classe	14
org.axiondb.constraints.UniqueConstraint	classe	1
org.axiondb.constraints.CheckConstraint	classe	5
org.axiondb.constraints.BaseSelectableBasedConstraint	classe	6
org.axiondb.constraints.PrimaryKeyConstraint	classe	1
org.axiondb.constraints.BaseConstraint	classe	9
org.axiondb.constraints.NullConstraint	classe	1
org.axiondb.constraints.NotNullConstraint	classe	1
org.axiondb.util.BufferedRandomAccessFile	classe	5
org.axiondb.util.BTree	classe	60
org.axiondb.util.BTree$BTreeValueIterator	classe	3
org.axiondb.util.BTree$StateStack	classe	6
org.axiondb.util.BTree$State	classe	1
org.axiondb.util.IntListIteratorChain	classe	15
org.axiondb.util.IntListIteratorChain$SingleElementIntListIterator	classe	9
org.axiondb.util.ObjectBTree	classe	63
org.axiondb.util.ExceptionConverter	classe	9
org.axiondb.util.Utf8InputStreamConverter	classe	1
org.axiondb.util.IntIteratorIntListIterator	classe	9
org.axiondb.util.DataOutputOutputStream	classe	16
org.axiondb.DataTypeFactory	interface	1
org.axiondb.DataType	interface	34
org.axiondb.NotWhereNode	classe	7
org.axiondb.AxionException	classe	1
org.axiondb.Row	interface	7
org.axiondb.Table	interface	35
org.axiondb.RowIterator	interface	18
org.axiondb.Database	interface	23
org.axiondb.WhereNode	interface	1
org.axiondb.TransactableTable	interface	0
org.axiondb.parser.Parser	interface	1
org.axiondb.parser.AxionSqlParserConstants	interface	0
org.axiondb.parser.TokenMgrError	classe	3
org.axiondb.parser.ParseException	classe	2
org.axiondb.parser.SimpleCharStream	classe	22
org.axiondb.parser.AxionSqlParser	classe	188
org.axiondb.parser.Token	classe	2
org.axiondb.parser.AxionSqlParserTokenManager	classe	28
org.axiondb.Selectable	interface	4
org.axiondb.jdbc.AxionPreparedStatement	classe	67
org.axiondb.jdbc.AxionConnection	classe	61
org.axiondb.jdbc.AxionDriver	classe	7
org.axiondb.jdbc.BaseAxionStatement	classe	18
org.axiondb.jdbc.AxionDataSource	classe	6
org.axiondb.jdbc.AxionStatement	classe	45
org.axiondb.jdbc.AxionClob	interface	11
org.axiondb.jdbc.AxionBlob	interface	9
org.axiondb.jdbc.AxionResultSet	classe	199
org.axiondb.jdbc.AxionResultSetMetaData	classe	26
org.axiondb.jdbc.ConnectionFactory	classe	2
org.axiondb.jdbc.AbstractAxionClob	classe	12
org.axiondb.jdbc.AbstractAxionBlob	classe	11
org.axiondb.jdbc.AxionDatabaseMetaData	classe	176
org.axiondb.IndexFactory	interface	1
org.axiondb.RowSource	interface	4
org.axiondb.Column	classe	4
org.axiondb.RowDecoratorIterator	interface	13
org.axiondb.NamedIdentifier	classe	1
org.axiondb.JoinedRowIterator	interface	3
org.axiondb.Literal	classe	9
org.axiondb.FunctionFactory	interface	1
org.axiondb.BranchWhereNode	classe	0
org.axiondb.SelectableBasedConstraint	interface	3
org.axiondb.BindVariable	classe	5
org.axiondb.Constraint	interface	9
org.axiondb.functions.CoalesceFunction	classe	4
org.axiondb.functions.ScalarFunction	interface	1
org.axiondb.functions.MatchesFunction	classe	5
org.axiondb.functions.FunctionIdentifier	classe	9
org.axiondb.functions.ConcreteFunction	interface	1
org.axiondb.functions.BaseFunction	classe	9
org.axiondb.functions.CountFunction	classe	5
org.axiondb.functions.MinFunction	classe	5
org.axiondb.functions.MaxFunction	classe	5
org.axiondb.functions.ConcatFunction	classe	4
org.axiondb.functions.LikeToRegexpFunction	classe	5
org.axiondb.functions.CharFunction	classe	4
org.axiondb.functions.LowerFunction	classe	4
org.axiondb.functions.AggregateFunction	interface	1
org.axiondb.functions.IfThenFunction	classe	4
org.axiondb.functions.Base64EncodeFunction	classe	5
org.axiondb.functions.NowFunction	classe	4
org.axiondb.functions.ContainsFunction	classe	4
org.axiondb.functions.Base64DecodeFunction	classe	4
org.axiondb.functions.RowNumFunction	classe	4
org.axiondb.functions.UpperFunction	classe	4
org.axiondb.TableIdentifier	classe	7
org.axiondb.expression.Expression	classe	17
org.axiondb.expression.ExpressionIdentifier	classe	10
org.axiondb.LeafWhereNode	classe	14
org.axiondb.engine.DiskDatabase	classe	9
org.axiondb.engine.BaseBTreeIndex	classe	2
org.axiondb.engine.BaseWhereNodeVisitor	classe	7
org.axiondb.engine.BTreeIndexFactory	classe	1
org.axiondb.engine.DiskTableFactory	classe	1
org.axiondb.engine.TransactionManagerImpl	classe	9
org.axiondb.engine.ArrayIndexFactory	classe	1
org.axiondb.engine.AxionTypesMetaTableUpdater	classe	2
org.axiondb.engine.SortedMapIndex	classe	16
org.axiondb.engine.SortedMapIndex$IntMapEntry	classe	3
org.axiondb.engine.SnapshotIsolationTransaction	classe	38
org.axiondb.engine.BaseArrayIndex	classe	15
org.axiondb.engine.FlattenWhereNodeVisitor	classe	5
org.axiondb.engine.ReferencesOtherTablesWhereNodeVisitor	classe	3
org.axiondb.engine.ObjectBTreeIndex	classe	7
org.axiondb.engine.FindBindVariableWhereNodeVisitor	classe	3
org.axiondb.engine.Databases	classe	3
org.axiondb.engine.MemoryTableFactory	classe	1
org.axiondb.engine.BaseDiskTable	classe	22
org.axiondb.engine.SimpleRow	classe	3
org.axiondb.engine.ClearBindVariableWhereNodeVisitor	classe	1
org.axiondb.engine.AxionColumnsMetaTableUpdater	classe	12
org.axiondb.engine.ObjectArrayIndex	classe	8
org.axiondb.engine.TransactableTableImpl	classe	52
org.axiondb.engine.TransactableTableImpl$TransactableTableRowIterator	classe	2
org.axiondb.engine.TransactableTableImpl$ExcludeDeleted	classe	1
org.axiondb.engine.TransactableTableImpl$ExcludeUpdated	classe	1
org.axiondb.engine.TransactableTableImpl$TransformUpdated	classe	3
org.axiondb.engine.TransactableTableImpl$InsertedRowIterator	classe	1
org.axiondb.engine.MemoryDatabase	classe	3
org.axiondb.engine.ObjectBTreeIndexLoader	classe	2
org.axiondb.engine.LazyRow	classe	4
org.axiondb.engine.ObjectArrayIndexLoader	classe	2
org.axiondb.engine.MemoryTable	classe	12
org.axiondb.engine.BaseTable	classe	38
org.axiondb.engine.IntBTreeIndexLoader	classe	2
org.axiondb.engine.SortedMapIndexLoader	classe	3
org.axiondb.engine.rowiterators.CollatingRowIterator	classe	20
org.axiondb.engine.rowiterators.UnmodifiableRowIterator	classe	4
org.axiondb.engine.rowiterators.ChangingIndexedRowIterator	classe	5
org.axiondb.engine.rowiterators.TransformingRowIterator	classe	6
org.axiondb.engine.rowiterators.RowIteratorRowDecoratorIterator	classe	19
org.axiondb.engine.rowiterators.JoinedRow	classe	4
org.axiondb.engine.rowiterators.AbstractFilteringRowIterator	classe	25
org.axiondb.engine.rowiterators.LazyRowRowIterator	classe	14
org.axiondb.engine.rowiterators.SimpleJoinedRowIterator	classe	14
org.axiondb.engine.rowiterators.EmptyRowIterator	classe	18
org.axiondb.engine.rowiterators.LimitingRowIterator	classe	4
org.axiondb.engine.rowiterators.FilteringRowIterator	classe	2
org.axiondb.engine.rowiterators.BaseRowIterator	classe	8
org.axiondb.engine.rowiterators.IndexJoinedRowIterator	classe	4
org.axiondb.engine.rowiterators.RebindableIndexedRowIterator	classe	1
org.axiondb.engine.rowiterators.BaseJoinedRowIterator	classe	16
org.axiondb.engine.rowiterators.DistinctRowIterator	classe	3
org.axiondb.engine.rowiterators.ChainedRowIterator	classe	14
org.axiondb.engine.rowiterators.SingleRowIterator	classe	18
org.axiondb.engine.rowiterators.ListIteratorRowIterator	classe	13
org.axiondb.engine.rowiterators.DelegatingRowIterator	classe	20
org.axiondb.engine.rowiterators.AbstractAcceptingRowIterator	classe	3
org.axiondb.engine.IntArrayIndexLoader	classe	2
org.axiondb.engine.commands.BaseAxionCommand	classe	12
org.axiondb.engine.commands.DeleteCommand	classe	9
org.axiondb.engine.commands.CreateSequenceCommand	classe	9
org.axiondb.engine.commands.CreateTableCommand	classe	14
org.axiondb.engine.commands.InsertCommand	classe	14
org.axiondb.engine.commands.AddConstraintCommand	classe	8
org.axiondb.engine.commands.CheckFileStateCommand	classe	6
org.axiondb.engine.commands.UpdateCommand	classe	15
org.axiondb.engine.commands.CollectBindVariablesWhereNodeVisitor	classe	2
org.axiondb.engine.commands.DropTableCommand	classe	4
org.axiondb.engine.commands.CheckpointCommand	classe	4
org.axiondb.engine.commands.ShutdownCommand	classe	4
org.axiondb.engine.commands.CreateIndexCommand	classe	17
org.axiondb.engine.commands.DropSequenceCommand	classe	4
org.axiondb.engine.commands.SelectCommand	classe	37
org.axiondb.engine.commands.DropConstraintCommand	classe	8
org.axiondb.engine.commands.RemountCommand	classe	15
org.axiondb.engine.BaseRow	classe	5
org.axiondb.engine.DiskSystemTable	classe	9
org.axiondb.engine.IntArrayIndex	classe	10
org.axiondb.engine.BaseIndex	classe	9
org.axiondb.engine.BaseDatabase	classe	42
org.axiondb.engine.AxionTablesMetaTableUpdater	classe	3
org.axiondb.engine.AxionSequencesMetaTableUpdater	classe	2
org.axiondb.engine.DiskTable	classe	36
org.axiondb.engine.IntBTreeIndex	classe	8
org.axiondb.BinaryBranchWhereNode	classe	13
org.axiondb.event.BaseTableModificationPublisher	classe	4
org.axiondb.event.RowUpdatedEvent	classe	1
org.axiondb.event.DatabaseModificationListener	interface	5
org.axiondb.event.ConstraintEvent	classe	4
org.axiondb.event.BaseTableModificationListener	classe	6
org.axiondb.event.SequenceModificationListener	interface	1
org.axiondb.event.DatabaseModifiedEvent	classe	1
org.axiondb.event.ColumnEvent	classe	4
org.axiondb.event.RowDeletedEvent	classe	1
org.axiondb.event.BaseDatabaseModificationListener	classe	5
org.axiondb.event.RowEvent	classe	5
org.axiondb.event.TableModifiedEvent	classe	3
org.axiondb.event.DatabaseSequenceEvent	classe	2
org.axiondb.event.RowInsertedEvent	classe	1
org.axiondb.event.TableModificationListener	interface	6
org.axiondb.event.DatabaseTypeEvent	classe	2
org.axiondb.Function	interface	4
org.axiondb.TransactionConflictException	classe	0
org.axiondb.ColumnIdentifier	classe	15
org.axiondb.InWhereNode	classe	6
org.axiondb.WhereNodeVisitor	interface	1
org.axiondb.OrderNode	classe	5
org.axiondb.Transaction	interface	4
