com.anotherbigidea.flash.interfaces.SWFTags	State
com.anotherbigidea.flash.readers.MovieBuilder$TextBuilder	(Object)Adapter
at.bestsolution.drawswf.drawobjects.Picture	(Object)Adapter
at.bestsolution.drawswf.DrawingPanel	State
com.anotherbigidea.flash.readers.TagParser	(Object)Adapter
org.apache.batik.ext.awt.image.rendered.AbstractTiledRed	Template Method
org.apache.batik.ext.awt.image.rendered.TileGenerator	(Object)Adapter
org.apache.batik.ext.awt.image.PadMode	Singleton
com.anotherbigidea.flash.interfaces.SWFActions	Decorator
com.anotherbigidea.flash.interfaces.SWFTagTypes	Factory Method
org.apache.batik.ext.awt.image.rendered.LRUCache$LRUObj	State
org.apache.batik.ext.awt.image.SVGComposite$AlphaPreCompositeContext	Template Method
com.incors.plaf.kunststoff.KunststoffCheckBoxUI	Singleton
com.incors.plaf.kunststoff.GradientTheme	State
org.apache.batik.ext.awt.image.SVGComposite$AlphaPreCompositeContext_INT_PACK	Template Method
org.apache.batik.ext.awt.image.SVGComposite	Singleton
org.apache.batik.ext.awt.image.rendered.TileMap	(Object)Adapter
org.apache.batik.ext.awt.image.rendered.TileGenerator	State
com.anotherbigidea.flash.writers.TagWriter	(Object)Adapter
com.incors.plaf.kunststoff.KunststoffToolBarUI	Singleton
com.anotherbigidea.flash.writers.SWFWriter	(Object)Adapter
at.bestsolution.drawswf.util.DrawSWFConfig	Singleton
at.bestsolution.ext.awt.FontLoader	Singleton
at.bestsolution.ext.swing.GradientJRadioButton	(Object)Adapter
com.anotherbigidea.flash.structs.Matrix	(Object)Adapter
com.anotherbigidea.flash.readers.MovieBuilder	State
org.apache.batik.ext.awt.image.rendered.TileMap	State
com.anotherbigidea.flash.structs.FillStyle	(Object)Adapter
com.anotherbigidea.flash.Unprotector	Decorator
com.anotherbigidea.flash.interfaces.SWFTagTypes	State
com.anotherbigidea.flash.movie.TimeLine	State
com.anotherbigidea.io.OutStream	(Object)Adapter
com.incors.plaf.kunststoff.KunststoffToggleButtonUI	Singleton
com.anotherbigidea.flash.writers.SWFTagTypesImpl	Decorator
at.bestsolution.drawswf.DrawObjectList	(Object)Adapter
at.bestsolution.drawswf.LineWidthChooser	(Object)Adapter
com.incors.plaf.kunststoff.KunststoffButtonUI	Singleton
com.anotherbigidea.flash.readers.SWFReader	State
at.bestsolution.drawswf.actions.OpenOptionsDialogAction	(Object)Adapter
com.anotherbigidea.flash.interfaces.SWFTags	(Object)Adapter
com.anotherbigidea.flash.movie.Symbol	Template Method
at.bestsolution.drawswf.MainWindow	Singleton
org.apache.batik.ext.awt.image.CompositeRule	Singleton
at.bestsolution.ext.swing.dialog.JGradientChooser	Singleton
at.bestsolution.drawswf.dialog.FontDialog	(Object)Adapter
org.apache.batik.ext.awt.image.rendered.TileGrid	(Object)Adapter
at.bestsolution.drawswf.PictureDialog	(Object)Adapter
com.anotherbigidea.flash.movie.Text	(Object)Adapter
at.bestsolution.drawswf.actions.SetColorAction	(Object)Adapter
at.bestsolution.drawswf.drawobjects.DrawSWFFont	(Object)Adapter
com.anotherbigidea.flash.structs.Color	(Object)Adapter
org.apache.batik.ext.awt.image.rendered.TileGrid	State
at.bestsolution.ext.swing.dialog.AlphaColorChooser	Singleton
com.anotherbigidea.flash.movie.FontLoader$VectorImpl	(Object)Adapter
com.anotherbigidea.flash.movie.Font	(Object)Adapter
at.bestsolution.drawswf.actions.ObjectListAction	(Object)Adapter
com.anotherbigidea.flash.interfaces.SWFTags	Decorator
at.bestsolution.drawswf.drawobjects.Text	(Object)Adapter
com.anotherbigidea.flash.interfaces.SWFActions	State
at.bestsolution.drawswf.dialog.OptionsDialog	(Object)Adapter
com.anotherbigidea.flash.readers.MovieBuilder$ShapeBuilder	(Object)Adapter
at.bestsolution.drawswf.actions.GraphicTemplateAction	(Object)Adapter
at.bestsolution.drawswf.drawobjects.DrawObject	State
com.anotherbigidea.flash.readers.ActionParser	State
com.anotherbigidea.flash.writers.ActionWriter	(Object)Adapter
com.anotherbigidea.flash.structs.LineStyle	(Object)Adapter
at.bestsolution.drawswf.actions.SetLineWidthAction	(Object)Adapter
org.apache.batik.ext.awt.image.rendered.TileStore	Bridge
com.anotherbigidea.flash.movie.Shape	(Object)Adapter
com.anotherbigidea.flash.movie.Frame	State
com.anotherbigidea.flash.writers.SWFActionsImpl	Decorator
at.bestsolution.drawswf.IconProvider	Singleton
at.bestsolution.ext.swing.icon.GradientIcon	(Object)Adapter
at.bestsolution.ext.swing.GradientJRadioButtonMenuItem	(Object)Adapter
org.apache.batik.ext.awt.MultipleGradientPaintContext	Template Method
com.incors.plaf.kunststoff.KunststoffLookAndFeel	State
org.apache.batik.ext.awt.image.rendered.LRUCache$LRUNode	State
at.bestsolution.drawswf.plugin.remotesave.dialog.RemoteSaveDialog	Singleton
org.apache.batik.ext.awt.image.rendered.LRUCache	(Object)Adapter
at.bestsolution.drawswf.plugin.remotesave.util.RemoteSaveConfig	Singleton
com.anotherbigidea.flash.writers.TagWriter	State
com.anotherbigidea.flash.interfaces.SWFTagTypes	Decorator
com.anotherbigidea.flash.movie.Movie	(Object)Adapter
at.bestsolution.drawswf.AboutWindow	(Object)Adapter
at.bestsolution.drawswf.actions.AboutAction	(Object)Adapter
at.bestsolution.ext.swing.dialog.AlphaColorChooser	(Object)Adapter
com.anotherbigidea.flash.readers.MovieBuilder	(Object)Adapter
com.anotherbigidea.flash.interfaces.SWFTagTypes	(Object)Adapter
org.apache.batik.ext.awt.image.rendered.AbstractTiledRed	Bridge
com.anotherbigidea.flash.readers.TagParser	State
