freecs.core.Listener	Singleton
freecs.external.UserlistManager	Singleton
freecs.util.logger.LogWriter	Singleton
freecs.core.User	Proxy
freecs.external.xmlrpc.XmlRpcManager	Singleton
freecs.core.MembershipManager	Singleton
freecs.layout.TemplateManager	Singleton
freecs.interfaces.IServerPlugin	State
freecs.core.Group	Proxy
freecs.auth.AuthManager	Singleton
freecs.commands.CommandSet	Singleton
freecs.core.Group	State
freecs.core.UserManager	(Object)Adapter
freecs.util.TrafficMonitor	Singleton
freecs.core.RequestMonitor	Singleton
freecs.core.GroupManager	Singleton
freecs.auth.AuthManager	State
freecs.Server	Singleton
freecs.interfaces.IGroupPlugin	State
freecs.util.logger.LogCleaner	Singleton
freecs.auth.NoAuthentication	Singleton
freecs.core.UserManager$UserStore	(Object)Adapter
freecs.core.Responder	Singleton
freecs.auth.IAuthenticator	State
freecs.Server	State
freecs.core.CentralSelector	Singleton
freecs.core.UserManager	Singleton
freecs.util.FileMonitor	Singleton
