freecs.core.MessageParser	classe	21
freecs.core.MessageRenderer	classe	10
freecs.core.RequestEvaluator	classe	9
freecs.core.Group	classe	78
freecs.core.CanceledRequestException	classe	0
freecs.core.CentralSelector	classe	16
freecs.core.CentralSelector$KeepAliveTimeoutChecker	classe	1
freecs.core.CleanupClass	classe	2
freecs.core.User	classe	144
freecs.core.ScheduledAction	classe	8
freecs.core.ConnectionBuffer	classe	20
freecs.core.MembershipManager	classe	11
freecs.core.UserManager	classe	33
freecs.core.UserManager$UserStore	classe	9
freecs.core.UserManager$UserStore$UserStoreIterator	classe	3
freecs.core.RequestReader	classe	17
freecs.core.RequestQueue	classe	7
freecs.core.Listener	classe	8
freecs.core.RequestMonitor	classe	5
freecs.core.Membership	classe	22
freecs.core.GroupManager	classe	19
freecs.core.Responder	classe	7
freecs.util.TrafficMonitor	classe	5
freecs.util.TrafficMonitor$AddressState	classe	0
freecs.util.FileMonitor	classe	5
freecs.util.CookieGenerator	classe	3
freecs.util.logger.LogFile	classe	6
freecs.util.logger.LogFile$LogFileShrinker	classe	1
freecs.util.logger.LogCleaner	classe	7
freecs.util.logger.LogWriterBenchmark	classe	2
freecs.util.logger.LogDestination	interface	2
freecs.util.logger.LogWriter	classe	9
freecs.util.logger.LogWriter$LogEntry	classe	0
freecs.util.GroupUserList	classe	4
freecs.util.HttpAuth	classe	3
freecs.util.FadeColor	classe	3
freecs.util.ObjectBuffer	classe	12
freecs.util.HtmlEncoder	classe	12
freecs.util.EntityDecoder	classe	8
freecs.util.HttpDateParser	classe	2
freecs.util.MessageTemplateFinder	classe	2
freecs.util.HashUtils	classe	1
freecs.auth.AuthManager	classe	20
freecs.auth.AbstractAuthenticator	classe	6
freecs.auth.NoAuthentication	classe	5
freecs.auth.sqlConnectionPool.ConnectionPool	classe	6
freecs.auth.sqlConnectionPool.DbProperties	classe	5
freecs.auth.sqlConnectionPool.PoolElement	classe	16
freecs.auth.sqlConnectionPool.SqlRunner	classe	5
freecs.auth.SQLAuthenticator	classe	6
freecs.auth.IAuthenticator	interface	5
freecs.auth.XmlRpcAuthenticator	classe	5
freecs.layout.TemplateSet	classe	21
freecs.layout.TemplateManager	classe	11
freecs.layout.Template	classe	23
freecs.content.MessageState	classe	4
freecs.content.BanObject	classe	2
freecs.content.PrivateMessageStore	classe	0
freecs.content.CallMembershipObject	classe	0
freecs.content.PersonalizedMessage	classe	5
freecs.content.Connection	classe	7
freecs.content.ContentContainer	classe	27
freecs.content.ActionstoreObject	classe	3
freecs.content.HTTPRequest	classe	19
freecs.commands.CmdAct	classe	5
freecs.commands.CmdLock	classe	5
freecs.commands.CommandSet	classe	16
freecs.commands.CmdUnlock	classe	5
freecs.commands.CmdUnPunish	classe	5
freecs.commands.CmdThink	classe	5
freecs.commands.CmdShowIp	classe	7
freecs.commands.CmdListOnlineFriends	classe	5
freecs.commands.CmdRepeatedPrivateMessage	classe	5
freecs.commands.CmdListAllFriends	classe	5
freecs.commands.CmdResetQuestioncounter	classe	5
freecs.commands.CmdJoinClosed	classe	6
freecs.commands.CmdReplyMessage	classe	5
freecs.commands.CmdPunish	classe	5
freecs.commands.CmdRightChange	classe	6
freecs.commands.CmdQuestion	classe	5
freecs.commands.CmdAck	classe	5
freecs.commands.CmdHitDice	classe	5
freecs.commands.AbstractCommand	classe	28
freecs.commands.CmdFriendsOnly	classe	5
freecs.commands.CmdKickHard	classe	5
freecs.commands.CmdAccept	classe	5
freecs.commands.CmdBan	classe	5
freecs.commands.CmdInviteAll	classe	6
freecs.commands.CmdSys	classe	5
freecs.commands.CmdUnBan	classe	5
freecs.commands.CmdIgnore	classe	6
freecs.commands.CmdInvite	classe	5
freecs.commands.CmdShout	classe	5
freecs.commands.CmdRSu	classe	6
freecs.commands.CmdFun	classe	5
freecs.commands.CmdQuit	classe	5
freecs.commands.CmdSepa	classe	5
freecs.commands.CmdRespectUser	classe	6
freecs.commands.CmdShowTime	classe	5
freecs.commands.CmdListUsers	classe	5
freecs.commands.CmdAway	classe	6
freecs.commands.CmdListVips	classe	5
freecs.commands.CmdKick	classe	5
freecs.commands.CmdChangeColor	classe	5
freecs.commands.CmdAddFriend	classe	5
freecs.commands.CmdChangeBgcolor	classe	8
freecs.commands.CmdKickToRoom	classe	5
freecs.commands.CmdSetTheme	classe	5
freecs.commands.CmdPrivateMessage	classe	5
freecs.commands.CmdJoin	classe	6
freecs.commands.CmdLockChangeForeignAction	classe	8
freecs.commands.CmdJoinUser	classe	6
freecs.commands.CmdSu	classe	6
freecs.commands.CmdClear	classe	5
freecs.commands.CmdRemoveFriend	classe	5
freecs.commands.CmdShowUserDetail	classe	5
freecs.commands.CmdListBan	classe	6
freecs.commands.CmdMyCol	classe	5
freecs.commands.CmdCallMemberships	classe	5
freecs.Server	classe	64
freecs.external.IRequestHandler	interface	4
freecs.external.CmdConfirmHandler	classe	5
freecs.external.AccessForbiddenException	classe	1
freecs.external.AdminCore	classe	5
freecs.external.UserlistRequestHandler	classe	6
freecs.external.AbstractRequestHandler	classe	4
freecs.external.StaticRequestHandler	classe	5
freecs.external.StaticRequestHandler$FileProperties	classe	0
freecs.external.StateRequestHandler	classe	7
freecs.external.WebadminRequestHandler	classe	34
freecs.external.xmlrpc.XmlRpcManager	classe	2
freecs.external.xmlrpc.freecsXmlRpcHandler	classe	12
freecs.external.UserlistManager	classe	7
freecs.interfaces.IRequest	interface	14
freecs.interfaces.IUserStates	interface	0
freecs.interfaces.IGroupState	interface	0
freecs.interfaces.IActionStates	interface	0
freecs.interfaces.IMessageDestination	interface	3
freecs.interfaces.ICommand	interface	4
freecs.interfaces.IServerPlugin	interface	13
freecs.interfaces.IGroupReason	interface	0
freecs.interfaces.IResponseHeaders	interface	0
freecs.interfaces.IGroupPlugin	interface	6
freecs.interfaces.IContainer	interface	3
freecs.interfaces.IXmlRpcHandler	interface	3
freecs.interfaces.IReloadable	interface	6
