FindAllAction	(Object)Adapter
TokenSource	State
gnu.regexp.RE	Proxy2
ParseSubState	Singleton
org.jext.console.commands.Command	State
org.gjt.sp.jedit.syntax.MultiModeTokenMarkerWithContext	State
gnu.regexp.RETokenLookAhead	Proxy2
com.microstar.xml.XmlHandler	State
HyperTyperSequenceList	Observer
org.jext.misc.SwingWorker	Bridge
org.jext.JextTextArea	(Object)Adapter
org.jext.gui.Skin	State
com.incors.plaf.kunststoff.KunststoffCheckBoxUI	Singleton
org.jext.project.DefaultProjectManager	(Object)Adapter
com.incors.plaf.kunststoff.GradientTheme	State
com.incors.plaf.kunststoff.KunststoffToolBarUI	Singleton
org.jext.JextFrame	(Object)Adapter
Options$DisplayIro	Factory Method
FindAllPlugin	(Object)Adapter
org.gjt.sp.jedit.textarea.TextAreaDefaults	Singleton
org.gjt.sp.jedit.textarea.InputHandler	Bridge
org.jext.gui.BundledSkinFactory$PlasticSkin	(Object)Adapter
com.incors.plaf.kunststoff.KunststoffButtonUI	Singleton
org.jext.JextFrame	Observer
org.gjt.sp.jedit.syntax.TokenMarkerWithAddToken	State
JBrowse	State
JBrowseParser$LineSource	(Object)Adapter
org.jext.console.commands.Command	Chain of Responsibility
org.gjt.sp.jedit.textarea.TextAreaHighlight	Decorator
org.jext.JextFrame	State
gnu.regexp.REToken	Chain of Responsibility
org.gjt.sp.jedit.syntax.TokenMarkerContext	State
JBrowseParser	State
SequenceChangedListener	Observer
gnu.regexp.REToken	Template Method
com.microstar.xml.XmlParser	State
org.jext.gui.SkinManager	State
gnu.regexp.RESyntax	Singleton
org.jext.search.SearchHighlight	(Object)Adapter
JBrowseOptionPane	State
HyperTyperPlugin	(Object)Adapter
org.gjt.sp.jedit.textarea.Gutter	State
org.jext.misc.HandlingRunnable	Bridge
org.gjt.sp.jedit.syntax.ASPPerlscriptTokenMarker	(Object)Adapter
JBrowseLineParser	(Object)Adapter
org.jext.options.OptionsDialog	State
Options$Display	(Object)Adapter
gnu.regexp.REToken	Decorator
gnu.regexp.RETokenLookAhead	Decorator
gnu.regexp.RETokenRepeated	Decorator
org.jext.project.Project	(Object)Adapter
com.incors.plaf.kunststoff.KunststoffLookAndFeel	State
FunnyBrackets	(Object)Adapter
org.jext.gui.Dockable	State
org.gjt.sp.jedit.syntax.ASPTokenMarker	State
FunnyBracketsPlugin	(Object)Adapter
UML$Type	Singleton
Options	(Object)Adapter
JBrowseParser$Results	(Object)Adapter
gnu.regexp.RE	(Object)Adapter
UMLTree$Node	(Object)Adapter
org.jext.gui.PlasticSettings	(Object)Adapter
HyperTyperObjectManager	(Object)Adapter
org.jext.misc.FindFilterFactory	Factory Method
ParseState	Singleton
gnu.regexp.CharIndexed	State
org.jext.project.DefaultProjectManager	State
com.incors.plaf.kunststoff.KunststoffToggleButtonUI	Singleton
JBrowseParser$LineSource	State
org.jext.search.SearchHighlight	Decorator
org.jext.project.Project	State
gnu.regexp.REToken	Proxy2
Options$DisplayIro	State
org.gjt.sp.jedit.syntax.TokenMarkerDebugger	(Object)Adapter
org.jext.project.AbstractProjectManager	Observer
org.jext.event.JextListener	Observer
org.gjt.sp.jedit.textarea.InputHandler$MacroRecorder	Bridge
JBrowseLineParser	State
org.jext.options.OptionsDialog	Singleton
org.gjt.sp.jedit.textarea.TextAreaPainter	State
UMLTree$CellRenderer	State
org.gjt.sp.jedit.textarea.TextAreaHighlight	State
gnu.regexp.RE	Decorator
org.jext.Plugin	State
gnu.regexp.REMatchEnumeration	State
org.jext.project.ProjectManager	State
org.jext.project.ProjectListener	Observer
org.jext.gui.DockChangeHandler	State
org.gjt.sp.jedit.textarea.JEditTextArea	Singleton
org.gjt.sp.jedit.syntax.TokenMarker	Template Method
org.jext.search.RESearchMatcher	(Object)Adapter
FindAll	(Object)Adapter
org.jext.console.Console	State
PropertyAccessor	State
JEditLineSource	(Object)Adapter
org.jext.project.ProjectManagement	Factory Method
org.gjt.sp.jedit.syntax.MultiModeToken	Singleton
