org.jgrapht.AllTests	classe	1
org.jgrapht.AllTests$ExpandableTestSuite	classe	1
org.jgrapht.experimental.permutation.CompoundPermutationIterTest	classe	1
org.jgrapht.experimental.isomorphism.IntegerVertexFactory	classe	1
org.jgrapht.experimental.isomorphism.comparators.DirectedEdgeWeightOddEvenComparator	classe	2
org.jgrapht.experimental.isomorphism.comparators.Mod3GroupComparator	classe	2
org.jgrapht.experimental.isomorphism.comparators.OddEvenGroupComparator	classe	2
org.jgrapht.experimental.isomorphism.IsomorphismInspectorTest	classe	10
org.jgrapht.experimental.isomorphism.EdgeTopologyCompare	classe	1
org.jgrapht.experimental.dag.DirectedAcyclicGraphTest	classe	8
org.jgrapht.experimental.dag.DirectedAcyclicGraphTest$LongVertexFactory	classe	1
org.jgrapht.experimental.dag.DirectedAcyclicGraphTest$RepeatableRandomGraphGenerator	classe	1
org.jgrapht.experimental.equivalence.EquivalenceGroupCreatorTest	classe	6
org.jgrapht.util.PrefetchIteratorTest	classe	2
org.jgrapht.util.PrefetchIteratorTest$IterateFrom1To99	classe	5
org.jgrapht.util.StopWatch	classe	2
org.jgrapht.util.AllUtilTests	classe	1
org.jgrapht.util.FibonacciHeapTest	classe	2
org.jgrapht.EnhancedTestCase	classe	2
org.jgrapht.ext.MatrixExporterTest	classe	3
org.jgrapht.ext.DOTExporterTest	classe	2
org.jgrapht.ext.GmlExporterTest	classe	1
org.jgrapht.ext.GraphMLExporterTest	classe	1
org.jgrapht.graph.GenericGraphsTest	classe	7
org.jgrapht.graph.GenericGraphsTest$CustomEdge	classe	1
org.jgrapht.graph.GenericGraphsTest$EquivVertex	classe	2
org.jgrapht.graph.GenericGraphsTest$EquivGraph	classe	0
org.jgrapht.graph.GenericGraphsTest$FooEdge	classe	0
org.jgrapht.graph.GenericGraphsTest$FooVertex	classe	0
org.jgrapht.graph.GenericGraphsTest$BarEdge	classe	0
org.jgrapht.graph.GenericGraphsTest$BarVertex	classe	0
org.jgrapht.graph.AsUnweightedGraphTest	classe	4
org.jgrapht.graph.AllGraphTests	classe	1
org.jgrapht.graph.SerializationTest	classe	2
org.jgrapht.graph.AsUndirectedGraphTest	classe	8
org.jgrapht.graph.DefaultDirectedGraphTest	classe	9
org.jgrapht.graph.DefaultDirectedGraphTest$LinkedHashSetFactory	classe	1
org.jgrapht.graph.SubgraphTest	classe	4
org.jgrapht.graph.ListenableGraphTest	classe	3
org.jgrapht.graph.ListenableGraphTest$MyGraphListner	classe	4
org.jgrapht.graph.AsWeightedGraphTest	classe	3
org.jgrapht.graph.SimpleDirectedGraphTest	classe	22
org.jgrapht.graph.CloneTest	classe	2
org.jgrapht.graph.CloneTest$BrokenVertex	classe	1
org.jgrapht.generate.GraphGeneratorTest	classe	8
org.jgrapht.generate.RandomGraphGeneratorTest	classe	3
org.jgrapht.generate.AllGenerateTests	classe	1
org.jgrapht.traverse.ClosestFirstIteratorTest	classe	5
org.jgrapht.traverse.DepthFirstIteratorTest	classe	5
org.jgrapht.traverse.IgnoreDirectionTest	classe	4
org.jgrapht.traverse.AbstractGraphIteratorTest	classe	6
org.jgrapht.traverse.AbstractGraphIteratorTest$MyTraversalListener	classe	6
org.jgrapht.traverse.TopologicalOrderIteratorTest	classe	2
org.jgrapht.traverse.BreadthFirstIteratorTest	classe	3
org.jgrapht.traverse.AllTraverseTests	classe	1
org.jgrapht.alg.EulerianCircuitTest	classe	1
org.jgrapht.alg.KShortestPathCompleteGraph6	classe	2
org.jgrapht.alg.ShortestPathTestCase	classe	4
org.jgrapht.alg.KShortestPathCostTest	classe	3
org.jgrapht.alg.NeighborIndexTest	classe	2
org.jgrapht.alg.TransitiveClosureTest	classe	2
org.jgrapht.alg.ConnectivityInspectorTest	classe	7
org.jgrapht.alg.BiconnectedGraph	classe	2
org.jgrapht.alg.KSPExampleGraph	classe	2
org.jgrapht.alg.Picture1Graph	classe	2
org.jgrapht.alg.FloydWarshallShortestPathsTest	classe	1
org.jgrapht.alg.NotBiconnectedGraph	classe	2
org.jgrapht.alg.EdmondsKarpMaximumFlowTest	classe	3
org.jgrapht.alg.BellmanFordShortestPathTest	classe	3
org.jgrapht.alg.DijkstraShortestPathTest	classe	2
org.jgrapht.alg.HamiltonianCycleTest	classe	1
org.jgrapht.alg.KSPExampleTest	classe	3
org.jgrapht.alg.BlockCutpointGraphTest	classe	5
org.jgrapht.alg.VertexCoversTest	classe	4
org.jgrapht.alg.KShortestPathKValuesTest	classe	6
org.jgrapht.alg.BiconnectivityInspectorTest	classe	4
org.jgrapht.alg.ChromaticNumberTest	classe	1
org.jgrapht.alg.KShortestPathCompleteGraph4	classe	2
org.jgrapht.alg.KShortestPathCompleteGraph5	classe	2
org.jgrapht.alg.CycleDetectorTest	classe	5
org.jgrapht.alg.AllAlgTests	classe	1
org.jgrapht.alg.BronKerboschCliqueFinderTest	classe	3
org.jgrapht.demo.JGraphAdapterDemo	classe	4
org.jgrapht.demo.JGraphAdapterDemo$ListenableDirectedMultigraph	classe	0
org.jgrapht.demo.PerformanceDemo	classe	3
org.jgrapht.demo.HelloJGraphT	classe	3
org.jgrapht.demo.CompleteGraphDemo	classe	2
org.jgrapht.experimental.permutation.PermutationFactory	classe	2
org.jgrapht.experimental.permutation.IntegerPermutationIter	classe	12
org.jgrapht.experimental.permutation.ArrayPermutationsIter	interface	2
org.jgrapht.experimental.permutation.CollectionPermutationIter	classe	6
org.jgrapht.experimental.permutation.CompoundPermutationIter	classe	10
org.jgrapht.experimental.PartiteRandomGraphGenerator	classe	1
org.jgrapht.experimental.isomorphism.AdaptiveIsomorphismInspectorFactory	classe	8
org.jgrapht.experimental.isomorphism.VertexDegreeEquivalenceComparator	classe	3
org.jgrapht.experimental.isomorphism.VertexDegreeEquivalenceComparator$InOutDegrees	classe	1
org.jgrapht.experimental.isomorphism.GraphIsomorphismInspector	interface	1
org.jgrapht.experimental.isomorphism.EquivalenceIsomorphismInspector	classe	4
org.jgrapht.experimental.isomorphism.PermutationIsomorphismInspector	classe	2
org.jgrapht.experimental.isomorphism.AbstractExhaustiveIsomorphismInspector	classe	10
org.jgrapht.experimental.isomorphism.AbstractExhaustiveIsomorphismInspector$NextFunctor	classe	1
org.jgrapht.experimental.isomorphism.IsomorphismRelation	classe	4
org.jgrapht.experimental.isomorphism.GraphOrdering	classe	4
org.jgrapht.experimental.isomorphism.GraphOrdering$LabelsEdge	classe	3
org.jgrapht.experimental.RandomGraphHelper	classe	2
org.jgrapht.experimental.GraphReader	classe	5
org.jgrapht.experimental.GraphReader$IntVertexFactory	classe	1
org.jgrapht.experimental.dag.DirectedAcyclicGraph	classe	13
org.jgrapht.experimental.dag.DirectedAcyclicGraph$TopoOrderMapping	interface	5
org.jgrapht.experimental.dag.DirectedAcyclicGraph$TopoOrderMappingFactory	interface	1
org.jgrapht.experimental.dag.DirectedAcyclicGraph$Visited	interface	3
org.jgrapht.experimental.dag.DirectedAcyclicGraph$VisitedFactory	interface	1
org.jgrapht.experimental.dag.DirectedAcyclicGraph$TopoComparator	classe	1
org.jgrapht.experimental.dag.DirectedAcyclicGraph$TopoVertexBiMap	classe	6
org.jgrapht.experimental.dag.DirectedAcyclicGraph$TopoVertexMap	classe	7
org.jgrapht.experimental.dag.DirectedAcyclicGraph$Region	classe	2
org.jgrapht.experimental.dag.DirectedAcyclicGraph$VisitedBitSetImpl	classe	5
org.jgrapht.experimental.dag.DirectedAcyclicGraph$VisitedArrayListImpl	classe	5
org.jgrapht.experimental.dag.DirectedAcyclicGraph$VisitedHashSetImpl	classe	4
org.jgrapht.experimental.dag.DirectedAcyclicGraph$VisitedArrayImpl	classe	4
org.jgrapht.experimental.dag.DirectedAcyclicGraph$CycleFoundException	classe	0
org.jgrapht.experimental.dag.DirectedAcyclicGraph$TopoIterator	classe	4
org.jgrapht.experimental.equivalence.EquivalenceComparatorChain	interface	1
org.jgrapht.experimental.equivalence.EquivalenceComparatorChainBase	classe	3
org.jgrapht.experimental.equivalence.EquivalenceSet	classe	9
org.jgrapht.experimental.equivalence.EquivalenceSetCreator	classe	3
org.jgrapht.experimental.equivalence.EquivalenceSetCreator$EqGroupSizeComparator	classe	1
org.jgrapht.experimental.equivalence.EquivalenceComparator	interface	2
org.jgrapht.experimental.equivalence.UniformEquivalenceComparator	classe	2
org.jgrapht.experimental.touchgraph.TouchgraphConverter	classe	1
org.jgrapht.experimental.touchgraph.TouchgraphPanel	classe	2
org.jgrapht.experimental.touchgraph.SimpleTouchgraphApplet	classe	3
org.jgrapht.experimental.GraphSquare	classe	11
org.jgrapht.experimental.UniformRandomGraphGenerator	classe	1
org.jgrapht.experimental.GraphTests	classe	5
org.jgrapht.experimental.alg.ApproximationAlgorithm	interface	3
org.jgrapht.experimental.alg.color.BrownBacktrackColoring	classe	2
org.jgrapht.experimental.alg.color.GreedyColoring	classe	6
org.jgrapht.experimental.alg.IntArrayGraphAlgorithm	classe	0
org.jgrapht.experimental.alg.ExactAlgorithm	interface	1
org.jgrapht.ListenableGraph	interface	4
org.jgrapht.util.ModifiableInteger	classe	14
org.jgrapht.util.FibonacciHeapNode	classe	3
org.jgrapht.util.WeightCombiner	interface	1
org.jgrapht.util.FibonacciHeap	classe	14
org.jgrapht.util.TypeUtil	classe	1
org.jgrapht.util.ArrayUnenforcedSet	classe	2
org.jgrapht.util.ArrayUnenforcedSet$SetForEquality	classe	2
org.jgrapht.util.MathUtil	classe	1
org.jgrapht.util.PrefetchIterator	classe	7
org.jgrapht.util.PrefetchIterator$NextElementFunctor	interface	1
org.jgrapht.VertexFactory	interface	1
org.jgrapht.Graph	interface	21
org.jgrapht.GraphPath	interface	5
org.jgrapht.ext.StringNameProvider	classe	1
org.jgrapht.ext.IntegerNameProvider	classe	2
org.jgrapht.ext.EdgeNameProvider	interface	1
org.jgrapht.ext.JGraphModelAdapter	classe	24
org.jgrapht.ext.JGraphModelAdapter$CellFactory	interface	2
org.jgrapht.ext.JGraphModelAdapter$DefaultCellFactory	classe	2
org.jgrapht.ext.JGraphModelAdapter$JGraphListener	classe	8
org.jgrapht.ext.JGraphModelAdapter$JGraphTListener	classe	4
org.jgrapht.ext.JGraphModelAdapter$ShieldedGraph	classe	9
org.jgrapht.ext.DOTExporter	classe	2
org.jgrapht.ext.IntegerEdgeNameProvider	classe	2
org.jgrapht.ext.VisioExporter	classe	3
org.jgrapht.ext.StringEdgeNameProvider	classe	1
org.jgrapht.ext.MatrixExporter	classe	6
org.jgrapht.ext.GraphMLExporter	classe	1
org.jgrapht.ext.VertexNameProvider	interface	1
org.jgrapht.ext.GmlExporter	classe	9
org.jgrapht.graph.UndirectedGraphUnion	classe	1
org.jgrapht.graph.SimpleGraph	classe	0
org.jgrapht.graph.DefaultGraphMapping	classe	2
org.jgrapht.graph.WeightedPseudograph	classe	0
org.jgrapht.graph.UndirectedMaskSubgraph	classe	0
org.jgrapht.graph.MaskEdgeSet	classe	3
org.jgrapht.graph.MaskEdgeSet$MaskEdgeSetNextElementFunctor	classe	2
org.jgrapht.graph.Pseudograph	classe	0
org.jgrapht.graph.MaskFunctor	interface	2
org.jgrapht.graph.GraphUnion	classe	19
org.jgrapht.graph.DirectedMaskSubgraph	classe	0
org.jgrapht.graph.DirectedMultigraph	classe	0
org.jgrapht.graph.AbstractBaseGraph	classe	30
org.jgrapht.graph.AbstractBaseGraph$Specifics	classe	12
org.jgrapht.graph.AbstractBaseGraph$ArrayListFactory	classe	1
org.jgrapht.graph.AbstractBaseGraph$DirectedEdgeContainer	classe	6
org.jgrapht.graph.AbstractBaseGraph$DirectedSpecifics	classe	13
org.jgrapht.graph.AbstractBaseGraph$UndirectedEdgeContainer	classe	4
org.jgrapht.graph.AbstractBaseGraph$UndirectedSpecifics	classe	13
org.jgrapht.graph.Multigraph	classe	0
org.jgrapht.graph.DefaultDirectedGraph	classe	0
org.jgrapht.graph.DefaultWeightedEdge	classe	1
org.jgrapht.graph.ListenableDirectedWeightedGraph	classe	0
org.jgrapht.graph.DirectedGraphUnion	classe	4
org.jgrapht.graph.AsUnweightedGraph	classe	1
org.jgrapht.graph.EdgeSetFactory	interface	1
org.jgrapht.graph.GraphDelegator	classe	24
org.jgrapht.graph.DefaultListenableGraph	classe	20
org.jgrapht.graph.DefaultListenableGraph$FlyweightEdgeEvent	classe	2
org.jgrapht.graph.DefaultListenableGraph$FlyweightVertexEvent	classe	2
org.jgrapht.graph.AsUndirectedGraph	classe	10
org.jgrapht.graph.ClassBasedVertexFactory	classe	1
org.jgrapht.graph.DefaultEdge	classe	3
org.jgrapht.graph.MaskVertexSet	classe	3
org.jgrapht.graph.MaskVertexSet$MaskVertexSetNextElementFunctor	classe	1
org.jgrapht.graph.ListenableUndirectedGraph	classe	0
org.jgrapht.graph.DirectedWeightedSubgraph	classe	0
org.jgrapht.graph.ListenableUndirectedWeightedGraph	classe	0
org.jgrapht.graph.AsUnweightedDirectedGraph	classe	1
org.jgrapht.graph.DefaultDirectedWeightedGraph	classe	0
org.jgrapht.graph.IntrusiveEdge	classe	1
org.jgrapht.graph.UnmodifiableGraph	classe	9
org.jgrapht.graph.GraphPathImpl	classe	6
org.jgrapht.graph.Subgraph	classe	21
org.jgrapht.graph.Subgraph$BaseGraphListener	classe	4
org.jgrapht.graph.UndirectedWeightedSubgraph	classe	0
org.jgrapht.graph.DirectedPseudograph	classe	0
org.jgrapht.graph.AbstractGraph	classe	8
org.jgrapht.graph.MaskSubgraph	classe	25
org.jgrapht.graph.ClassBasedEdgeFactory	classe	1
org.jgrapht.graph.SimpleWeightedGraph	classe	0
org.jgrapht.graph.SimpleDirectedWeightedGraph	classe	0
org.jgrapht.graph.UnmodifiableUndirectedGraph	classe	0
org.jgrapht.graph.UndirectedSubgraph	classe	1
org.jgrapht.graph.WeightedMultigraph	classe	0
org.jgrapht.graph.EdgeReversedGraph	classe	12
org.jgrapht.graph.AsWeightedGraph	classe	2
org.jgrapht.graph.ListenableDirectedGraph	classe	0
org.jgrapht.graph.UnmodifiableDirectedGraph	classe	0
org.jgrapht.graph.ParanoidGraph	classe	3
org.jgrapht.graph.DirectedWeightedMultigraph	classe	0
org.jgrapht.graph.DirectedSubgraph	classe	4
org.jgrapht.graph.SimpleDirectedGraph	classe	0
org.jgrapht.GraphHelper	classe	0
org.jgrapht.Graphs	classe	15
org.jgrapht.DirectedGraph	interface	4
org.jgrapht.WeightedGraph	interface	1
org.jgrapht.generate.HyperCubeGraphGenerator	classe	1
org.jgrapht.generate.RingGraphGenerator	classe	1
org.jgrapht.generate.WheelGraphGenerator	classe	1
org.jgrapht.generate.ScaleFreeGraphGenerator	classe	1
org.jgrapht.generate.LinearGraphGenerator	classe	1
org.jgrapht.generate.CompleteGraphGenerator	classe	1
org.jgrapht.generate.RandomGraphGenerator	classe	4
org.jgrapht.generate.RandomGraphGenerator$EdgeTopologyFactory	interface	2
org.jgrapht.generate.RandomGraphGenerator$DefaultEdgeTopologyFactory	classe	3
org.jgrapht.generate.EmptyGraphGenerator	classe	1
org.jgrapht.generate.CompleteBipartiteGraphGenerator	classe	1
org.jgrapht.generate.GraphGenerator	interface	1
org.jgrapht.generate.StarGraphGenerator	classe	1
org.jgrapht.UndirectedGraph	interface	1
org.jgrapht.traverse.TopologicalOrderIterator	classe	6
org.jgrapht.traverse.TopologicalOrderIterator$LinkedListQueue	classe	5
org.jgrapht.traverse.CrossComponentIterator	classe	16
org.jgrapht.traverse.CrossComponentIterator$VisitColor	enum	0
org.jgrapht.traverse.CrossComponentIterator$SimpleContainer	interface	3
org.jgrapht.traverse.CrossComponentIterator$Specifics	classe	1
org.jgrapht.traverse.CrossComponentIterator$FlyweightEdgeEvent	classe	1
org.jgrapht.traverse.CrossComponentIterator$FlyweightVertexEvent	classe	1
org.jgrapht.traverse.CrossComponentIterator$DirectedSpecifics	classe	1
org.jgrapht.traverse.CrossComponentIterator$UndirectedSpecifics	classe	1
org.jgrapht.traverse.AbstractGraphIterator	classe	12
org.jgrapht.traverse.ClosestFirstIterator	classe	11
org.jgrapht.traverse.ClosestFirstIterator$QueueEntry	classe	0
org.jgrapht.traverse.BreadthFirstIterator	classe	4
org.jgrapht.traverse.DepthFirstIterator	classe	6
org.jgrapht.traverse.GraphIterator	interface	6
org.jgrapht.EdgeFactory	interface	1
org.jgrapht.GraphMapping	interface	2
org.jgrapht.event.VertexSetListener	interface	2
org.jgrapht.event.EdgeTraversalEvent	classe	1
org.jgrapht.event.TraversalListener	interface	5
org.jgrapht.event.GraphEdgeChangeEvent	classe	1
org.jgrapht.event.VertexTraversalEvent	classe	1
org.jgrapht.event.GraphChangeEvent	classe	1
org.jgrapht.event.GraphListener	interface	2
org.jgrapht.event.TraversalListenerAdapter	classe	5
org.jgrapht.event.ConnectedComponentTraversalEvent	classe	1
org.jgrapht.event.GraphVertexChangeEvent	classe	1
org.jgrapht.alg.BlockCutpointGraph	classe	8
org.jgrapht.alg.BlockCutpointGraph$BCGEdge	classe	2
org.jgrapht.alg.BlockCutpointGraph$VertexComponentForbiddenFunction	classe	2
org.jgrapht.alg.KShortestPathsIterator	classe	12
org.jgrapht.alg.StrongConnectivityInspector	classe	7
org.jgrapht.alg.StrongConnectivityInspector$VertexData	classe	6
org.jgrapht.alg.StrongConnectivityInspector$VertexData1	classe	2
org.jgrapht.alg.StrongConnectivityInspector$VertexData2	classe	2
org.jgrapht.alg.BronKerboschCliqueFinder	classe	4
org.jgrapht.alg.ChromaticNumber	classe	1
org.jgrapht.alg.BellmanFordShortestPath	classe	5
org.jgrapht.alg.DijkstraShortestPath	classe	5
org.jgrapht.alg.RankingPathElement	classe	2
org.jgrapht.alg.EdmondsKarpMaximumFlow	classe	8
org.jgrapht.alg.EdmondsKarpMaximumFlow$Node	classe	0
org.jgrapht.alg.EdmondsKarpMaximumFlow$Arc	classe	0
org.jgrapht.alg.BellmanFordPathElement	classe	2
org.jgrapht.alg.FloydWarshallShortestPaths	classe	3
org.jgrapht.alg.util.VertexDegreeComparator	classe	1
org.jgrapht.alg.BiconnectivityInspector	classe	4
org.jgrapht.alg.ConnectivityInspector	classe	10
org.jgrapht.alg.ConnectivityInspector$MyTraversalListener	classe	3
org.jgrapht.alg.RankingPathElementList	classe	7
org.jgrapht.alg.TransitiveClosure	classe	2
org.jgrapht.alg.AbstractPathElementList	classe	3
org.jgrapht.alg.EulerianCircuit	classe	2
org.jgrapht.alg.DirectedNeighborIndex	classe	10
org.jgrapht.alg.HamiltonianCycle	classe	1
org.jgrapht.alg.KShortestPaths	classe	3
org.jgrapht.alg.KShortestPaths$PathWrapper	classe	6
org.jgrapht.alg.NeighborIndex	classe	7
org.jgrapht.alg.NeighborIndex$Neighbors	classe	4
org.jgrapht.alg.VertexCovers	classe	2
org.jgrapht.alg.CycleDetector	classe	5
org.jgrapht.alg.CycleDetector$CycleDetectedException	classe	0
org.jgrapht.alg.CycleDetector$ProbeIterator	classe	2
org.jgrapht.alg.BellmanFordIterator	classe	18
org.jgrapht.alg.AbstractPathElement	classe	5
