org.picocontainer.composers.RegexComposer	classe	1
org.picocontainer.monitors.NullComponentMonitor	classe	10
org.picocontainer.monitors.ComponentMonitorHelper	classe	6
org.picocontainer.monitors.AbstractComponentMonitor	classe	13
org.picocontainer.monitors.ConsoleComponentMonitor	classe	10
org.picocontainer.monitors.ComposingMonitor	classe	1
org.picocontainer.monitors.ComposingMonitor$Composer	interface	1
org.picocontainer.monitors.LifecycleComponentMonitor	classe	11
org.picocontainer.monitors.LifecycleComponentMonitor$LifecycleFailuresException	classe	2
org.picocontainer.monitors.WriterComponentMonitor	classe	10
org.picocontainer.visitors.MethodCallingVisitor	classe	6
org.picocontainer.visitors.VerifyingVisitor	classe	4
org.picocontainer.visitors.VerifyingVisitor$ComponentAdapterCollector	classe	5
org.picocontainer.visitors.AbstractPicoVisitor	classe	2
org.picocontainer.visitors.AbstractPicoVisitor$PicoVisitorTraversalException	classe	0
org.picocontainer.visitors.TraversalCheckingVisitor	classe	4
org.picocontainer.PicoCompositionException	classe	0
org.picocontainer.Disposable	interface	1
org.picocontainer.BindKey	classe	6
org.picocontainer.Characteristics	classe	2
org.picocontainer.Characteristics$ImmutableProperties	classe	5
org.picocontainer.ComponentMonitorStrategy	interface	2
org.picocontainer.ComponentFactory	interface	3
org.picocontainer.Parameter	interface	5
org.picocontainer.Parameter$Resolver	interface	3
org.picocontainer.Parameter$NotResolved	classe	3
org.picocontainer.Parameter$DelegateResolver	classe	3
org.picocontainer.Parameter$ValueResolver	classe	3
org.picocontainer.PicoVerificationException	classe	2
org.picocontainer.Converters	interface	2
org.picocontainer.MutablePicoContainer	interface	13
org.picocontainer.security.CustomPermissionsURLClassLoader	classe	5
org.picocontainer.InjectionFactory	interface	0
org.picocontainer.DefaultPicoContainer	classe	57
org.picocontainer.DefaultPicoContainer$LateInstance	classe	4
org.picocontainer.DefaultPicoContainer$KnowsContainerAdapter	classe	10
org.picocontainer.DefaultPicoContainer$AsPropertiesPicoContainer	classe	5
org.picocontainer.DefaultPicoContainer$IntoThreadLocal	classe	1
org.picocontainer.references.ThreadLocalMapObjectReference	classe	2
org.picocontainer.references.SimpleReference	classe	2
org.picocontainer.references.ThreadLocalReference	classe	2
org.picocontainer.Startable	interface	2
org.picocontainer.lifecycle.JavaEE5LifecycleStrategy	classe	5
org.picocontainer.lifecycle.ReflectionLifecycleException	classe	0
org.picocontainer.lifecycle.LifecycleState	interface	9
org.picocontainer.lifecycle.ReflectionLifecycleStrategy	classe	7
org.picocontainer.lifecycle.CompositeLifecycleStrategy	classe	5
org.picocontainer.lifecycle.DefaultLifecycleState	classe	10
org.picocontainer.lifecycle.StartableLifecycleStrategy	classe	14
org.picocontainer.lifecycle.AbstractMonitoringLifecycleStrategy	classe	3
org.picocontainer.lifecycle.NullLifecycleStrategy	classe	5
org.picocontainer.converters.ConvertsNothing	classe	2
org.picocontainer.converters.LongConverter	classe	1
org.picocontainer.converters.ShortConverter	classe	1
org.picocontainer.converters.FloatConverter	classe	1
org.picocontainer.converters.UrlConverter	classe	1
org.picocontainer.converters.BooleanConverter	classe	1
org.picocontainer.converters.IntegerConverter	classe	1
org.picocontainer.converters.Converter	interface	1
org.picocontainer.converters.BuiltInConverters	classe	5
org.picocontainer.converters.DoubleConverter	classe	1
org.picocontainer.converters.FileConverter	classe	1
org.picocontainer.converters.NewInstanceConverter	classe	1
org.picocontainer.converters.CharacterConverter	classe	1
org.picocontainer.converters.ByteConverter	classe	1
org.picocontainer.PicoLifecycleException	classe	3
org.picocontainer.Converting	interface	1
org.picocontainer.adapters.AbstractAdapter	classe	11
org.picocontainer.adapters.InstanceAdapter	classe	14
org.picocontainer.PicoContainer	interface	14
org.picocontainer.ComponentMonitor	interface	10
org.picocontainer.Emjection	classe	4
org.picocontainer.classname.ClassPathElement	classe	4
org.picocontainer.classname.ClassLoadingPicoContainer	interface	4
org.picocontainer.classname.ClassName	classe	6
org.picocontainer.classname.DefaultClassLoadingPicoContainer	classe	24
org.picocontainer.classname.DefaultClassLoadingPicoContainer$AsPropertiesPicoContainer	classe	35
org.picocontainer.behaviors.AbstractBehaviorFactory	classe	9
org.picocontainer.behaviors.Caching	classe	2
org.picocontainer.behaviors.Decorating	classe	2
org.picocontainer.behaviors.Synchronized	classe	2
org.picocontainer.behaviors.Guarded	classe	2
org.picocontainer.behaviors.Storing	classe	7
org.picocontainer.behaviors.Storing$StoreThreadLocal	classe	1
org.picocontainer.behaviors.Storing$StoreWrapper	classe	0
org.picocontainer.behaviors.Behaviors	classe	6
org.picocontainer.behaviors.Guarding	classe	2
org.picocontainer.behaviors.Intercepted	classe	5
org.picocontainer.behaviors.Intercepted$InterceptorThreadLocal	classe	1
org.picocontainer.behaviors.Intercepted$Controller	interface	9
org.picocontainer.behaviors.Intercepted$ControllerImpl	classe	9
org.picocontainer.behaviors.Intercepted$ControllerWrapper	classe	9
org.picocontainer.behaviors.PropertyApplicator	classe	12
org.picocontainer.behaviors.ThreadCached	classe	1
org.picocontainer.behaviors.Locked	classe	2
org.picocontainer.behaviors.ImplementationHiding	classe	2
org.picocontainer.behaviors.AdaptingBehavior	classe	13
org.picocontainer.behaviors.Automated	classe	2
org.picocontainer.behaviors.Decorated	classe	2
org.picocontainer.behaviors.Decorated$Decorator	interface	1
org.picocontainer.behaviors.Synchronizing	classe	2
org.picocontainer.behaviors.Stored	classe	12
org.picocontainer.behaviors.Stored$RealComponentLifecycle	classe	8
org.picocontainer.behaviors.Stored$NoComponentLifecycle	classe	5
org.picocontainer.behaviors.Stored$Instance	classe	0
org.picocontainer.behaviors.AbstractBehavior	classe	21
org.picocontainer.behaviors.Cached	classe	1
org.picocontainer.behaviors.OptInCaching	classe	2
org.picocontainer.behaviors.FieldDecorating	classe	2
org.picocontainer.behaviors.Intercepting	classe	1
org.picocontainer.behaviors.Automating	classe	2
org.picocontainer.behaviors.FieldDecorated	classe	2
org.picocontainer.behaviors.FieldDecorated$Decorator	interface	1
org.picocontainer.behaviors.HiddenImplementation	classe	5
org.picocontainer.behaviors.PropertyApplying	classe	2
org.picocontainer.behaviors.Locking	classe	2
org.picocontainer.behaviors.ThreadCaching	classe	2
org.picocontainer.injectors.CompositeInjection	classe	1
org.picocontainer.injectors.ProviderAdapter	classe	19
org.picocontainer.injectors.NamedFieldInjection	classe	2
org.picocontainer.injectors.NamedMethodInjection	classe	1
org.picocontainer.injectors.SetterInjection	classe	1
org.picocontainer.injectors.ParameterNameBinding	classe	1
org.picocontainer.injectors.AbstractInjector	classe	15
org.picocontainer.injectors.Provider	interface	0
org.picocontainer.injectors.FactoryInjector	classe	16
org.picocontainer.injectors.MultiInjector	classe	1
org.picocontainer.injectors.Injectors	classe	8
org.picocontainer.injectors.CompositeInjector	classe	6
org.picocontainer.injectors.AdaptingInjection	classe	9
org.picocontainer.injectors.AnnotatedFieldInjection	classe	1
org.picocontainer.injectors.ConstructorInjector	classe	10
org.picocontainer.injectors.Reinjection	classe	0
org.picocontainer.injectors.Reinjection$ReinjectionInjector	classe	1
org.picocontainer.injectors.ForgetfulConstructorInjection	classe	0
org.picocontainer.injectors.AbstractInjectionFactory	classe	3
org.picocontainer.injectors.AbstractInjectionFactory$LifecycleAdapter	classe	17
org.picocontainer.injectors.SetterInjector	classe	5
org.picocontainer.injectors.AnnotatedMethodInjector	classe	3
org.picocontainer.injectors.MethodInjection	classe	1
org.picocontainer.injectors.MethodInjection$MethodInjectionByName	classe	1
org.picocontainer.injectors.MethodInjection$MethodInjectionByReflectionMethod	classe	1
org.picocontainer.injectors.AnnotatedMethodInjection	classe	1
org.picocontainer.injectors.IterativeInjector	classe	19
org.picocontainer.injectors.TypedFieldInjector	classe	9
org.picocontainer.injectors.MultiInjection	classe	1
org.picocontainer.injectors.SingleMemberInjector	classe	7
org.picocontainer.injectors.MethodInjector	classe	8
org.picocontainer.injectors.PrimitiveMemberChecker	classe	1
org.picocontainer.injectors.NamedFieldInjector	classe	9
org.picocontainer.injectors.ConstructorInjection	classe	1
org.picocontainer.injectors.InjectInto	classe	3
org.picocontainer.injectors.AnnotatedFieldInjector	classe	8
org.picocontainer.injectors.NamedMethodInjector	classe	3
org.picocontainer.injectors.Reinjector	classe	7
org.picocontainer.injectors.TypedFieldInjection	classe	2
org.picocontainer.PicoClassNotFoundException	classe	0
org.picocontainer.NameBinding	interface	1
org.picocontainer.parameters.ComponentParameter	classe	3
org.picocontainer.parameters.ConstantParameter	classe	5
org.picocontainer.parameters.BasicComponentParameter	classe	12
org.picocontainer.parameters.AbstractParameter	classe	2
org.picocontainer.parameters.CollectionComponentParameter	classe	13
org.picocontainer.parameters.DefaultConstructorParameter	classe	5
org.picocontainer.parameters.NullParameter	classe	4
org.picocontainer.PicoBuilder	classe	33
org.picocontainer.PicoException	classe	0
org.picocontainer.LifecycleStrategy	interface	5
org.picocontainer.containers.EmptyPicoContainer	classe	16
org.picocontainer.containers.SystemPropertiesPicoContainer	classe	0
org.picocontainer.containers.CommandLinePicoContainer	classe	7
org.picocontainer.containers.CompositePicoContainer	classe	15
org.picocontainer.containers.CompositePicoContainer$CompositeConverters	classe	2
org.picocontainer.containers.PropertiesPicoContainer	classe	1
org.picocontainer.containers.CommandLineArgumentsPicoContainer	classe	0
org.picocontainer.containers.TransientPicoContainer	classe	0
org.picocontainer.containers.ImmutablePicoContainer	classe	18
org.picocontainer.containers.AbstractDelegatingPicoContainer	classe	18
org.picocontainer.containers.AbstractDelegatingMutablePicoContainer	classe	17
org.picocontainer.containers.TieringPicoContainer	classe	2
org.picocontainer.containers.TieringPicoContainer$TieringGuard	classe	6
org.picocontainer.containers.TieringPicoContainer$AskingParentForComponent	classe	1
org.picocontainer.PicoVisitor	interface	5
org.picocontainer.ComponentAdapter	interface	9
org.picocontainer.ComponentAdapter$NOTHING	classe	0
org.picocontainer.ObjectReference	interface	2
org.picocontainer.ComponentLifecycle	interface	5
org.picocontainer.BehaviorFactory	interface	2
